...........
...+-.--+.-
...|.......
...|....+-.
..-+....|..
...|.......
........|..
...+--.-+..
--.+.......
...|....|..
