..........
..+-.--+.-
..|.......
..|....+-.
.-+....|..
..|.......
.......|..
..+--.-+..
-.+.......
..|....|..
